||||||||||||||||||||||||||||||||||||||||||||||||||||||||||||||||||
||                                                              ||
||                                                              ||
||                  @                                           ||
||                                                              ||
||          \\====    ====//================        ==========  ||
||           \\          //        ||    ||             ||      ||
||            \\        //         ||    ||             ||      ||
||             \\      //          ||    ||             ||      ||
||              \\    //           ||    ||             ||      ||
||               \\  //            ||    ||             ||      ||
||                \\//    =========||    ||             ||      ||
||                                                      ||      ||
||                                                      ||      ||
||          ================================        ==========  ||
||                                                              ||
||                                                              ||
||||||||||||||||||||||||||||||||||||||||||||||||||||||||||||||||||